##########
#  ##  # #
#   #  ###
#  .B   ##
#   &B   #
#    .   #
# # B    #
#   .#   #
#  # #   #
##########
