##########
#        #
##  . B  #
#    #   #
#   &B . #
#      ###
# #   #  #
#   #    #
#        #
##########
