##########
##### ####
#   . .  #
#  #.    #
#   &B . #
## B B   #
#  ## B  #
# # #   ##
# ##     #
##########
