##########
#    #   #
# ## ##  #
#  #    ##
# . &B . #
#   ###  #
### B B  #
##  . #  #
#  #     #
##########
