##########
##  ##   #
##  ## ###
##      ##
####&B ###
###. B   #
##### #  #
#   .    #
#        #
##########
