##########
#       ##
#   .  # #
## BB .  #
# . &##  #
#    B   #
#   B  ###
#   .    #
#        #
##########
