##########
##########
##########
##########
# . & ####
#.BB  ####
## #B#####
#  #.#####
##    ####
##########
