##########
#        #
#   .    #
#  #B    #
#   &#   #
##       #
#   #    #
#   ##   #
#    ##  #
##########
