##########
####     #
# #     ##
# #  # ###
### ######
#  . B#  #
##  &    #
#   B  . #
###      #
##########
