##########
#        #
#   ###  #
#  B     #
### &B   #
### ###  #
#   B .  #
#   .  . #
#    #   #
##########
