##########
#       ##
#   .    #
#  BB  # #
# . &#   #
#    #   #
##  B    #
##  . #  #
#       ##
##########
