##########
##########
##########
##########
#   & ####
#  B######
# B  #####
## .. ####
#     ####
##########
