##########
##  #   ##
#        #
#  .B    #
# ##&#####
#        #
# # B    #
#  .  #  #
##       #
##########
