##########
##       #
##  ## ###
#   ##   #
##  &  # #
#   #    #
# B B .  #
#      . #
##  #    #
##########
