##########
##     ###
#        #
#   B    #
#   &.   #
###    ###
##  #    #
####     #
#     ####
##########
