##########
##########
##########
##########
#   & ####
# # # ####
#   . ####
## B  ####
#     ####
##########
