##########
##########
##########
##########
# . &#####
#.BB  ####
##  B#####
##  . ####
# #   ####
##########
