##########
#    #   #
#        #
#   .    #
#   &B   #
##       #
#   #    #
#   # ####
#     ## #
##########
