##########
##########
# # .   ##
#   B   ##
#   &#  ##
#  # B. ##
#   B  ###
# # .# ###
# #     ##
##########
