##########
##      ##
##  #    #
#  ## #  #
#   &B   #
#    .   #
#   #    #
##    # ##
##      ##
##########
