##########
##########
#       ##
# # #   ##
#   & # ##
#  #  # ##
##  B # ##
#   .   ##
#       ##
##########
