##########
##########
##########
##########
# # & ####
#  B  ####
#   . ####
#     ####
####  ####
##########
