##########
#      ###
#   .   ##
#  .B    #
#   &B   #
#     ## #
#   B    #
##  .    #
##       #
##########
