##########
#        #
##    &  #
#        #
# #### ###
#  . # # #
#   B B  #
##  . #  #
#        #
##########
