##########
#        #
#        #
#   .    #
#   &B   #
#        #
#        #
# ###    #
##       #
##########
