##########
##########
##########
##########
#   & ####
## B  ####
# . B ####
#  #. ####
#  #  ####
##########
