##########
## #  .  #
# . . B  #
# B B    #
#   &B ###
#    .   #
##      ##
###### # #
# ####   #
##########
